blouse - a piece of clothing for women that is like a shirt
think - to believe that something is true, or to expect that something will happen, although you are not sure
weather - the conditions in the air above the Earth such as wind, rain or temperature, especially at a particular time over a particular area
watch - to look at something for a period of time
August - the eighth month of the year, after July and before September
baby - a very young child
mom - a mother
week - a period of seven days
OK - used when agreeing to do something or when allowing someone to do something
thing - used to refer to something without saying its name
people - more than one person
farm - an area of land with fields and buildings, used for growing crops and/or keeping animals as a business
yellow - being the same color as a lemon or the sun
example - something that is typical of the group of things being talked about
teach - to give lessons in a particular subject at a school, university, etc.
below - in a lower position than someone or something else
pencil - a long, thin, wooden object with a black or colored point that you write or draw with
snow - soft white pieces of frozen water that fall from the sky when the weather is cold
dinner - the main meal of the day that people usually eat in the evening
tell - to say something to someone, usually giving them information
like - to enjoy something or feel that someone or something is pleasant
TV - television
February - the second month of the year, after January and before March
need - If you need something, you must have it.
an - used instead of "a" when the following word begins with a vowel sound
glass - a hard transparent substance that objects such as windows and bottles are made of
Wednesday - the day of the week after Tuesday and before Thursday
much - In questions, "much" is used to ask about the amount of something.
behind - at or to the back of someone or something
plane - a vehicle that flies and has at least one engine and wings
arm - the long part at each side of the human body, ending in a hand
anything - used  in questions or negatives to mean "something"
take - to get and carry something with you when you go somewhere
woman - an adult female person
us - used after a verb or preposition to refer to the person who is speaking or writing and one or more other people
word - a group of letters or sounds that mean something, or a single letter or sound that means something
eighteen - the number 18
December - the twelfth and last month of the year
under - below something, or below the surface of something
get - to obtain or buy something
coffee shop - a small restaurant where you can buy drinks and light meals, or a store that sells coffee drinks and snacks
again - once more
reading - the activity or skill of getting information from books, newspapers, etc.
band - a group of musicians who play modern music together
invite - to ask someone to come to a social event or to spend time with you socially
worry - used to tell someone that they do not need to think about something or do anything about something
easy - not difficult
village - a group of stores, houses, and other buildings that is smaller than a town
good - enjoyable, pleasant or interesting
refrigerator - a large container that uses electricity to keep food cold
great - very good
park - a large area of grass and trees in a city or town, where people can walk and enjoy themselves
dance - to move your feet and body to the rhythm of music
famous - known and recognized by many people
get - to obtain or buy something
good - enjoyable, pleasant or interesting
ice cream - a sweet, frozen food made from milk or cream, sugar, and a flavor
to - used with a verb to make an infinitive
them - used after a verb or preposition to refer to a group of people, animals, or things that have already been talked about
old - having lived or existed for many years
home - the place where you live or feel you belong
until - continuing to happen before a particular time or event and then stopping
next - the week/year/Monday, etc. that follows the present one
dancing - the activity of moving your feet and your body to the rhythm of music
very - used emphasize an adjective or adverb
good - enjoyable, pleasant or interesting
in - inside or toward the inside of a container, place or area
April - the fourth month of the year, after March and before May
her - used after a verb or preposition to refer to someone female who has already been talked about
banana - a long curved fruit with a yellow skin
bank - an organization or place where you can borrow money, save money, etc.
last - the week/year/Monday, etc. before the present one
think - to believe that something is true, or to expect that something will happen, although you are not sure
eleven - the number 11
present - the form of the verb that is used to show what happens or exists now
sentence - a group of words, usually containing a verb, that expresses a complete idea
red - being the same color as blood
life - the time between a person's birth and their death
the - used before nouns to refer to particular things or people that have already been talked about or are already known
beautiful - very attractive
more - something in addition to what you already have
answer - what you say or write back to someone who has asked you a question or spoken to you
July - the seventh month of the year, after June and before August
every - each one of a group of people or things
clean - not dirty
Mr. - a title for a man, used before his family name or full name
group - a number of people or things that are together in one place or are connected
wear - to have clothing, jewelery, etc. on your body
outside - not inside a building
page - a piece of paper in a book, magazine, etc., or one side of a piece of paper
four - the number 4
letter - a written message that you send to someone, usually in the mail
only - not more than a particular size or amount
really - very or very much
station - a building where trains or buses stop so that you can get on or off them
know - to have knowledge or information about something in your mind
wind - a natural, fast movement of air
water - the clear liquid that falls from the sky as rain and is necessary for animal and plant life
a - used before a noun to refer to a single thing or person but not a particular thing or person or not one that you have referred to before
work - the place where you go to do your job
paint - a colored liquid that you put on a surface such as a wall to decorate it, or that you use to produce a picture
which - used to ask or talk about a choice between two or more things
well - in a successful or satisfactory way
first - coming before all others
at - used to show the place or position of something
credit card - a small plastic card that allows you to buy something and pay for it later
noise - a sound, often a loud, unpleasant sound
above - in or to a higher position than something else
you - used to refer to the person or people you are talking to
favorite - best liked or most enjoyed
inside - in or into a room, building, container, etc.
orange - being a color that is a mixture of red and yellow
sad - unhappy or making you feel unhappy
ball - a round object that you throw, kick, or hit in a game, or something with this shape
dog - an animal with fur, four legs and a tail, especially kept by people as a pet or to hunt or guard buildings
fine - well, healthy, or happy
doctor - a person whose job is to treat people who are ill or hurt
leg - one of the parts of the body of a human or animal that is used for standing and walking
beard - the hair that grows on a man's chin
from - used to show the place where someone or something starts
sorry - used to apologize for something you have done
dress - a piece of clothing for women or girls which covers the top half of the body and hangs down over the legs
dad - a father
end - the final part of something such as a period of time, activity, or story
wake - to stop sleeping or to make someone else stop sleeping
to - used with a verb to make an infinitive
CD - compact disc: a small disc on which music or information is recorded
my - belonging to or relating to the person who is speaking or writing
late - happening or arriving after the planned, expected, usual or necessary time
pen - a long, thin object that you use to write or draw in ink
man - an adult male human being
swim - to move through water by moving your body
know - to have knowledge or information about something in your mind
see - to notice people and things with your eyes
a - used before a noun to refer to a single thing or person but not a particular thing or person or not one that you have referred to before
bathroom - a room with a sink, a toilet, and often a bathtub and/or shower
eraser - a small piece of rubber that is used to remove pencil marks from paper
hungry - wanting or needing food
apple - a hard, round fruit that has a green or red skin and is white inside
read - to look at words and understand what they mean
to - used with a verb to make an infinitive
open - available for business or serving customers
dining room - a room in which meals are eaten
sun - the large, bright star that shines in the sky during the day and provides light and heat for the Earth, or the light and heat that comes from the sun
city - a large town
subway - a system of trains that travel underground
eat - to put food into your mouth and then swallow it
cake - a sweet food made from flour, butter, sugar and eggs, mixed together and baked
leave - to go away from a place or a situation, either permanently or for a temporary period
restaurant - a place where you can buy and eat a meal
egg - an oval object with a hard shell which is produced by female birds, especially chickens, and which is eaten as food
short - small in length, distance or height
all right - happening successfully or without problems
boat - a vehicle for traveling on water
some - used to refer to an amount of something without saying exactly how much or how many
tennis - a sport in which two or four people hit a small ball to each other over a net
of - belonging or relating to someone or something
mother - a female parent
well - in a successful or satisfactory way
take - to get and carry something with you when you go somewhere
evening - the part of the day between the afternoon and the night
beach - an area of sand or small stones next to the ocean or a lake
stay - to remain in a place, job, etc. and not leave
and - used to join two words, phrases, parts of sentences or related statements together
late - happening or arriving after the planned, expected, usual or necessary time
can - to be able to
call - to have a particular name
about - relating to a particular subject or person
a.m. - used to refer to a time between twelve o'clock at night and twelve o'clock in the middle of the day
old - having lived or existed for many years
coffee -  a popular hot drink with a strong smell that is made from dark beans, or the beans or crushed beans from which this drink is made
our - belonging to or relating to us
today - on this day
play - When children play, they spend time enjoying themselves with toys and games.
before - earlier than something or someone
example - something that is typical of the group of things being talked about
course - a set of classes or a plan of study in a particular subject, usually a part of a program of study for a diploma, certificate, or degree
see - to notice people and things with your eyes
have - to own or possess
part - a piece that combines with other pieces to form the whole of something
happy - feeling, showing, or causing pleasure
remember - If you remember a fact or something from the past, you keep it in your mind, or bring it back into your mind.
from - used to show the place where someone or something starts
writing - the skill or activity of producing words on a surface
there - used to show that something exists or happens
nice - pleasant or attractive
language - a type of communication used by the people of a particular country or by a particular group of people
bottom - the lowest part of something
than - used to compare two different things or amounts
chair - a seat for one person, that has a back, usually four legs, and sometimes two arms
the - used before nouns to refer to particular things or people that have already been talked about or are already known
September - the ninth month of the year, after August and before October
last - the week/year/Monday, etc. before the present one
November - the eleventh month of the year, after October and before December
some - used to refer to an amount of something without saying exactly how much or how many
dollar - the unit of money used in the US, Canada, Australia, New Zealand and some other countries
good afternoon - something you say to someone when you meet them in the afternoon
boot - a strong shoe that covers your foot and part of your leg
the - used before nouns to refer to particular things or people that have already been talked about or are already known
look - to turn your eyes in the direction of something or someone so that you can see them
play - When children play, they spend time enjoying themselves with toys and games.
cannot - the negative form of "can"
close - If something closes, it moves so that it is not open, and if you close something, you make it move so that it is not open.
picture - a drawing, painting, or photograph of something or someone
fish - an animal that lives only in water and swims using its tail and fins
what - used to ask for information about something
a - used before a noun to refer to a single thing or person but not a particular thing or person or not one that you have referred to before
this - used to refer to something that you have already talked about
address - the details of where a building is, including the building number, street name, city or town, etc.
help - to make it easier for someone to do something by doing part of the work yourself
summer - the season of the year between spring and fall, when the weather is warmest
fine - well, healthy, or happy
watch - to look at something for a period of time
Miss - a title for a girl or woman who is not married, used before her family name or full name
tree - a tall plant with a thick stem which has branches coming from it and leaves
brown - being the color of chocolate or soil
pay - to give money to someone for something you are buying or using, or because you owe them money
wall - a vertical structure, often made of stone or brick, that divides or surrounds something
also - in addition
cheese - a food made from milk, which can either be firm or soft and is usually yellow or white in color
draw - to make a picture of something or someone with a pencil or pen
come - to move or travel toward a person who is speaking or the place that they are speaking about
where - used to ask about the place or position of someone or something
kind - a type of thing or person
paint - a colored liquid that you put on a surface such as a wall to decorate it, or that you use to produce a picture
meat - muscles and other soft parts of animals, used as food
how - used to ask someone if they are well and happy
get - to obtain or buy something
different - not the same
guitar - a musical instrument with six strings and a long neck which is usually made of wood, and which is played by pulling or hitting the strings with the fingers
him - used after a verb or preposition to refer to someone male who has already been talked about
check - to put a mark  by something written to show it is correct or has been done
birthday - the day on which someone was born, or the same date each year
we - used as the subject of the verb to refer to the speaker and at least one other person when considered together or as a group
jeans - pants made of denim, a strong cotton material, which are worn informally
with - used to say that people or things are in a place together or are doing something together
ear - one  of the two body parts on your head that you hear with
too - used before adjectives and adverbs to mean "more than is allowed, necessary, possible, etc."
interesting - Someone or something that is interesting keeps your attention because they are unusual, exciting, or have a lot of ideas.
after - when a time or event has happened
down - moving from above and onto a surface
buy - to get something by paying money for it
nationality - If you have United States/British/Swiss, etc. nationality, you are legally a member of that country.
money - the coins or bills  that are used to buy things
Thursday - the day of the week after Wednesday and before Friday
seven - the number 7
yes - used to agree with something, or to give a positive answer
brother - a man or boy with the same parents as another person
Friday - the day of the week after Thursday and before Saturday
gray - being a color that is a mixture of black and white
movie - a story shown in  moving pictures, shown in a theater or on television
hello - used to greet someone
rice - small grains from a plant that are cooked and eaten
hi - hello
enjoy - to get pleasure from something
oh - introduces an idea that you have just thought of, or something that you have just remembered
begin - to start to happen
tonight - during the night of the present day
this - used to refer to something that you have already talked about
put - to move something to a place or position
dear - used at the beginning of a letter to greet the person you are writing to
sugar - a sweet substance used to give flavor to food and drinks
rain -  water that falls from the sky in small drops
holiday - a day for celebration when many people are allowed to stay away from work or school
those - plural of "that"           
hair - the thin, thread-like parts that grow on your head
study - to learn about a subject, especially in school  or college or by reading books
please - used to make a request more polite
its - belonging to or relating to something that has already been mentioned
funny - making you smile or laugh
shower - the act of washing yourself while standing under a flow of water
color - red, blue, green, yellow, etc.
class - a group of students who have lessons together
fat - Someone who is fat weighs too much.
back - where someone or something was before
store - a building or part of a building where you can buy things
carry - to hold something or someone with your hands, arms, or on your back and take them from one place to another
talk - to say things to someone
quick - doing something fast
all - every person or thing in a group
hot - having a high temperature
skirt - a piece of clothing for women and girls that hangs from the waist and does not have legs
floor - a surface that you walk on inside a building
on - on or onto a surface
speak - to say something using your voice
same - exactly alike
long - continuing for a large amount of time
plate - a flat, round object that is used for putting food on
closed - not open
live - to have your home somewhere
cow - a large female farm animal kept to produce meat and milk
hotel - a place where you pay to stay when you are away from home
fourteen - the number 14
fun - enjoyment or pleasure, or something that gives you enjoyment or pleasure
love - to like something very much
plant - a living thing that grows in the soil or water and has leaves and roots, especially one that is smaller than a tree
fast - moving or happening quickly, or able to move or happen quickly
be - used to give information about someone or something
television - a piece of equipment in the shape of a box, with a screen on the front, used for watching programs
beautiful - very attractive
at - used to show the place or position of something
love - to like something very much
best - (<span class="i">superlative of
as - used to talk about the job someone has
bus - a large vehicle in which people are driven from one place to another
need - If you need something, you must have it.
white - being the color of snow or milk
in - inside or toward the inside of a container, place or area
street - a road in a town or city that has houses or other buildings
key - a piece of metal cut into a particular shape that is used for opening or closing the lock of a door, starting a car engine, etc.
son - your male child
excuse - used to politely get someone's attention
visit - to go to someone's home and spend time with them
quarter - a period of 15 minutes before or after the hour
adult - a person or animal that has grown to full size and strength
animal - something that lives and moves but is not a human, bird, fish or insect
car - a road vehicle with an engine, four wheels, and seats for a small number of people
number - a symbol or word used in a counting system or used to show the position or order of something
the Internet - the system that connects computers all over the world and allows people who use computers to look at websites 
nineteen - the number 19
question - a sentence or phrase used to find out information
Saturday - the day of the week after Friday and before Sunday
newspaper - large, folded sheets of paper which are printed with the news and sold every day or every week
speak - to say something using your voice
your - belonging or relating to the person or group of people being spoken or written to
catch - to take hold of something, especially something that is moving through the air
hat - something you wear to cover your head, for fashion or protection
bookcase - a piece of furniture with shelves for putting books on
this - used to refer to something that you have already talked about
clean - not dirty
send - to arrange for something to go to or be delivered somewhere or to someone
bird - an animal that has wings and feathers, and is usually able to fly
visit - to go to someone's home and spend time with them
sport - a game or activity which people do to keep healthy or for enjoyment, often competing against each other
game - an entertaining activity or sport that people play
not - used to form a negative phrase after verbs like "be," "can," "have," "'will," "must," etc., usually used in the short form "n't" in speech
photo - a picture produced using a camera
from - used to show the place where someone or something starts
write - to produce letters, words or numbers on a surface or computer
nose - the part of your face through which you breathe and smell
open - available for business or serving customers
one - the number 1
wash - to clean something using water
two - the number 2
first - coming before all others
tomorrow - on the day after today
father - your male parent
lunch - a meal that is eaten in the middle of the day
wife - the woman a man is married to
black - being the darkest color there is, like the color of coal or of a very dark night
drink - a liquid or an amount of liquid which is taken into the body through the mouth
soon - used for saying goodbye to someone you are going to meet again soon
why - used to ask about the reason for something
p.m. - used to refer to a time after midday but before midnight
do - used with another verb to form questions and negative phrases
June - the sixth month of the year, after May and before July
slow - doing, moving or happening without much speed
like - to enjoy something or feel that someone or something is pleasant
waiter - a man who works in a restaurant, bringing food to customers
about - relating to a particular subject or person
good evening - something you say to greet someone in the evening
movie - a story shown in  moving pictures, shown in a theater or on television
fish - an animal that lives only in water and swims using its tail and fins
date - a particular day of a month or year
street - a road in a town or city that has houses or other buildings
football - an oval ball made of leather or plastic and filled with air, used in playing football
camera - a device for taking photographs or making films or television programs
show - to let someone look at something
desk - a type of table that you can work at, often one with drawers
work - the place where you go to do your job
radio - a piece of equipment used for listening to sound broadcasts
give - to provide someone with something
winter - the coldest season of the year, between fall and spring
feel - to experience something physical or emotional
television - a piece of equipment in the shape of a box, with a screen on the front, used for watching programs
choose - to decide what you want from two or more things or possibilities
board - a surface on the wall of a classroom that a teacher writes on
good morning - something you say to greet someone when you meet them in the morning
kitchen - a room where food is kept, prepared, and cooked and where the dishes are washed
good - enjoyable, pleasant or interesting
ten - the number 10
a - used before a noun to refer to a single thing or person but not a particular thing or person or not one that you have referred to before
other - as well as the person or thing already mentioned
Monday - the day of the week after Sunday and before Tuesday
test - a set of questions to measure someone's knowledge or ability
family - a group of people who are related to each other, such as a mother, a father, and their children
right - correct or true
chocolate - a sweet, usually brown, food that is prepared and sold in a block, or a small sweet made from this
see - to notice people and things with your eyes
many - a large number of 
waitress - a woman who works in a restaurant, bringing food to customers
butter - a pale yellow food made from cream that you put on bread or use in cooking
only - not more than a particular size or amount
of - belonging or relating to someone or something
close - If something closes, it moves so that it is not open, and if you close something, you make it move so that it is not open.
any - used in questions and negatives to mean some
good night - something you say when you leave someone or they leave you in the evening, or when you are going to bed
from - used to show the place where someone or something starts
bean - a seed, or the pod containing seeds, of various climbing plants, eaten as a vegetable
get - to obtain or buy something
blue - being  the same color as the sky when there are no clouds
on - on or onto a surface
come - to move or travel toward a person who is speaking or the place that they are speaking about
near - close in distance
meet - to see and speak to someone for the first time
supermarket - a large store that sells many different foods and other products used in the home
foot - one of the two flat parts on the ends of your legs that you stand on
number - a symbol or word used in a counting system or used to show the position or order of something
for - intended to be given to or used by someone or something
hear - to be aware of a sound through your ears
OK - used when agreeing to do something or when allowing someone to do something
who - used to ask about someone's name or which person or group someone is talking about
homework - work that teachers give students to do at home
food - something that people and animals eat, or plants absorb, to keep them alive
pig - a large pink, brown or black farm animal with short legs and a curved tail, kept for its meat
do - used with another verb to form questions and negative phrases
Tuesday - the day of the week after Monday and before Wednesday
thing - used to refer to something without saying its name
lot - a large amount or number of people or things
as - used to talk about the job someone has
say - to speak words
between - in the space that separates two places, people or objects
player - someone who takes part in a game or sport
that - used to refer to something or someone that can be seen or pointed to
swimming pool - an area of water that has been made for people to swim in
conversation - a talk between two or more people, usually an informal one
breakfast - the food you eat in the morning after you wake up
dark - nearer to black than white in color
twenty - the number 20
sweet - with a taste like sugar
tired - feeling that you want to rest or sleep
many - a large number of 
no - something that you say in order to disagree, give a negative answer, or say that something is not true
sometimes - on some occasions but not always or often
parent - your mother or father
these - plural of "this"           
past - used to say what the time is when it is a particular number of minutes after an hour
eat - to put food into your mouth and then swallow it
morning - the first half of the day, from the time when the sun rises or you wake up until the middle of the day
have - to own or possess
practice - to do or play something regularly or repeatedly in order to become skilled at it
music - a pattern of sounds that is made by playing instruments or singing, or a recording of this
mouth - the part of the face that is used for eating and speaking
later - used for saying goodbye to someone you are going to meet again soon, especially during the same day
twelve - the number 12
little - small in size or amount
learn - to get knowledge or skill in a new subject or activity
time - a particular point in the day or night
meal - an occasion when food is eaten, or the food which is eaten on such an occasion
meet - to see and speak to someone for the first time
room - a part of the inside of a building that is separated from other parts by walls, floor and ceiling
expensive - costing a lot of money
e-mail - the system for using computers to send messages over the Internet
wrong - not correct
CD player - a machine that is used for playing music CDs 
warm - having a temperature between cool and hot
yesterday - on the day before today
go - to move or travel somewhere
between - in the space that separates two places, people or objects
sit - to be in a position with the weight of your body on your bottom and the top part of your body up, for example, on a chair
light - Light colors are pale.
flower - the attractive, colored part of a plant where the seeds grow
computer - an electronic machine that can store and arrange large amounts of information
find - to discover something or someone that you have been searching for
closed - not open
ride - to travel by sitting on a horse, bicycle, or motorcycle and controlling it
e-mail - the system for using computers to send messages over the Internet
better - (<span class="i">comparative of
with - used to say that people or things are in a place together or are doing something together
kick - to hit someone or something with the foot, or to move the feet and legs suddenly and violently
same - exactly alike
stop - to not continue doing something that you were doing
well - in a successful or satisfactory way
go - to move or travel somewhere
shower - the act of washing yourself while standing under a flow of water
morning - the first half of the day, from the time when the sun rises or you wake up until the middle of the day
oh - introduces an idea that you have just thought of, or something that you have just remembered
their - belonging to or relating to a group of people, animals, or things that have already been talked about
cross - a written mark (x), usually used to show where something is, or that something has not been written correctly
vacation - a period of time to relax or travel for pleasure instead of doing your usual work or school activities
class - a group of students who have lessons together
can - to be able to
wait - to stay in a place until someone or something arrives, or until someone or something is ready for you
shirt - a piece of clothing worn on the top part of the body, often made of thin material like cotton and fastened with buttons down the front
there - used to show that something exists or happens
tooth - one of the hard white objects in the mouth, which are used for biting and chewing
drive - to move or travel on land in a motor vehicle, especially as the person controlling the vehicle's movement
body - the whole physical structure that forms a person or animal
world - the Earth and all the people, places and things on it
table - a piece of furniture with four legs, used for eating off, putting things on, etc.
name - the word or words that a person, thing or place is known by
milk - a white liquid produced by women and other female animals, such as cows
picnic - a meal that you make and take with you somewhere to eat outside
river - a long, natural area of water that flows across land and into the ocean, a lake, another river, etc.
all right - happening successfully or without problems
place - a position, building, town, area, etc.
hand - the part of your body on the end of your arm that has fingers and a thumb
box - a square or rectangular container
business - the activity of buying and selling goods and services
teacher - someone whose job is to teach in a school or college
when - used to ask at what time something happened or will happen
friend - someone  who you know well and like
toilet - a bowl that you sit on or stand near when you get rid of waste substances from your body
often - many times or regularly
party - a social event where people enjoy themselves by talking, eating, drinking, and dancing
not - used to form a negative phrase after verbs like "be," "can," "have," "'will," "must," etc., usually used in the short form "n't" in speech
because - used to give a reason for something
safe - not in danger or likely to be harmed
smoking - when someone smokes a cigarette or regularly smokes cigarettes
they - used as the subject of the verb when referring to a group of people, animals, or things that have already been talked about
café - a small restaurant where you can buy drinks and light meals
very - used emphasize an adjective or adverb
garden - a piece of land belonging to a house, where flowers and other plants are grown
slim - Someone who is slim is thin in an attractive way.
will - used to talk about what someone or something is able or willing to do
age - the number of years that someone has lived, or that something has existed
morning - the first half of the day, from the time when the sun rises or you wake up until the middle of the day
pizza - a large circle of flat bread baked with cheese, tomatoes, and sometimes meat and vegetables spread on top
any - used in questions and negatives to mean some
more - something in addition to what you already have
both - used to talk about two people or things
May - the fifth month of the year, after April and before June
baseball - (the ball used in) a game played by two teams of nine players, in which a player hits a ball with a bat and tries to run around the four corners of a large square area of the field before the other team returns the ball
do - used with another verb to form questions and negative phrases
orange - being a color that is a mixture of red and yellow
day - a period of 24 hours
no - something that you say in order to disagree, give a negative answer, or say that something is not true
walk - to move forward by putting one foot in front of the other and then repeating the action
shopping - the activity of buying things from shops
afternoon - the time between the middle of the day and the evening
use - If you use something, you do something with it for a particular purpose.
take - to get and carry something with you when you go somewhere
how - used to ask someone if they are well and happy
stop - to not continue doing something that you were doing
she - used to refer to a woman, girl or female animal that has already been mentioned
finish - to complete something, or come to the end of an activity
of - belonging or relating to someone or something
new - recently made or having started to exist recently
answer - what you say or write back to someone who has asked you a question or spoken to you
it - used to refer to the thing, situation, or idea that has already been talked about
together - with each other or doing something with each other
always - every time, or at all times
exciting - making you feel very happy and enthusiastic
at - used to show the place or position of something
road - a route between places, usually with a hard surface built for vehicles to drive on
for - intended to be given to or used by someone or something
Web site - a set of pages of information on the Internet about a particular subject that have been published by the same person or organization and that often contain color pictures, video, and sound
eye - one of the two organs in your face, which you use to see with
good - enjoyable, pleasant or interesting
clothes - items such as shirts, dresses and trousers that you wear on  your body
night - the time in every 24 hours when it is dark and people usually sleep
factory - a building or set of buildings where large amounts of goods are made using machines
and - used to join two words, phrases, parts of sentences or related statements together
minute - a period of time equal to 60 seconds
green - being the same color as grass
see - to notice people and things with your eyes
on - on or onto a surface
classroom - a room in a school or college where groups of students are taught
train - a long, thin vehicle which travels along metal tracks and carries people or goods
well - in a successful or satisfactory way
subject - an area of knowledge which is studied in school or college
new - recently made or having started to exist recently
eight - the number 8
sing - to make musical sounds with your voice
small - little in size or amount
Sunday - the day of the week after Saturday and before Monday
October - the tenth month of the year, after September and before November
young - having lived or existed for only a short time and not old
here - in the place where you are
important - valuable, useful or necessary
dictionary - a book that contains a list of words in alphabetical order with their meanings explained or written in another language, or a similar product for use on a computer
but - used to introduce an added statement, usually something that is different from what you have said before
door - a flat object, often fixed at one edge, that is used to close the entrance of something such as a room or building, or the entrance itself
his - belonging to or relating to someone male who has already been talked about
person - a human being
bag - a container made of paper, plastic, leather, etc., used for carrying things
then - at that time
girl - a female child or young woman
nine - the number 9
paper - thin, flat material used for writing or drawing on, covering things in, etc.
hard - difficult to understand or do
movie theater - a building where you go to watch movies
note - a short letter
something - used to refer to a thing when you do not know what it is or when it is not important what it is
week - a period of seven days
big - large in size or amount
house - a building where people live, usually one family or group
would - used to say politely that you want something
coat - an outer piece of clothing with sleeves that is worn over other clothes, usually for warmth
excited - feeling very happy and enthusiastic
basketball - a game in which two teams try to score points by throwing a ball through a high net, or the ball used in this game
seventeen - the number 17
museum - a building where you can look at important objects connected with art, history, or science
love - to like something very much
get - to obtain or buy something
busy - If you are busy, you are working hard, or giving your attention to a particular thing
year - a period of twelve months, especially from January 1st to December 31st
cold - having a low temperature
hour - a period of 60 minutes
tea - a hot drink that you make by pouring water onto dried leaves, or the leaves that you use to make this drink
run - to move on your feet at a faster speed than walking
month - one of the twelve periods of time that a year is divided into
radio - a piece of equipment used for listening to sound broadcasts
thanks - thank you           
up - vertical or as straight as possible
potato - a round vegetable with a brown, yellow, or red skin that grows in the ground
ad - an advertisement
cheap - costing little money or less than is usual or expected
rain -  water that falls from the sky in small drops
group - a number of people or things that are together in one place or are connected
do - used with another verb to form questions and negative phrases
every - each one of a group of people or things
boring - not interesting or exciting
lot - a large amount or number of people or things
January - the first month of the year, after December and before February
early - near the beginning of a period of time, process, etc.
forget - remember
husband - the man a woman is married to
message - a piece of writing or spoken information that one person gives to another
ask - to say a question to someone which you want them to answer
smoke - to breathe smoke into your mouth from a cigarette
March - the third month of the year, after February and before April
each - every one  in a group of two or more things or people when they are considered separately
come - to move or travel toward a person who is speaking or the place that they are speaking about
doll - a child's toy that looks like a small person or baby
horse - a large animal with four legs, which people ride on or use for carrying things or pulling vehicles
be - used to give information about someone or something
start - to begin doing something
I - used when the person speaking or writing is the subject of the verb
cook - to prepare food and usually heat it
six - the number 6
change - to stop having or using one thing, and start having or using another
listen - to give attention to someone or something in order to hear them
three - the number 3
that - used to refer to something or someone that can be seen or pointed to
small - little in size or amount
much - In questions, "much" is used to ask about the amount of something.
make - to produce or create something
university - a place where students study at a high level to get a degree
pants - a piece of clothing that covers the lower part of the body and has a separate part for each leg
problem - a situation that causes difficulties and that needs to be dealt with
Mrs. - a title for a married woman, used before her family name or full name
bed - a piece of furniture that you sleep on
short - small in length, distance or height
thirteen - the number 13
into - toward the inside or middle of something
go - to move or travel somewhere
child - a boy or girl who is not yet an adult, or a son or daughter of any age
daughter - your female child
want - to hope to have or do something, or to wish for something
anything - used  in questions or negatives to mean "something"
pair - two people who are doing something together
bedroom - a room used for sleeping in
head - the part of the body above the neck that contains your brain, eyes, nose, mouth, ears, etc., and on which your hair grows
color - red, blue, green, yellow, etc.
work - the place where you go to do your job
hello - used to greet someone
jacket - a short coat
some - used to refer to an amount of something without saying exactly how much or how many
what - used to ask for information about something
dance - to move your feet and body to the rhythm of music
second - immediately after the first and before any others
be - used to give information about someone or something
wine - an alcoholic drink that is usually made from grapes, or sometimes from other fruit
best - (<span class="i">superlative of
he - used to refer to a man, boy, or male animal that has already been mentioned
finish - to complete something, or come to the end of an activity
DVD - digital versatile disc or digital video disc: a disc used for storing and playing music, films or information
sheep - a farm animal whose skin is covered with wool
bad - unpleasant; causing difficulties or harm
clock - a piece of equipment that shows you what time it is, usually in  a house  or on a building and not worn by a person
sandwich - two slices of bread with meat, cheese, etc. between them
school - a place where children go to be educated
cup - a small round container, often with a handle, used for drinking tea, coffee, etc.
die - to stop living or existing
address - the details of where a building is, including the building number, street name, city or town, etc.
number - a symbol or word used in a counting system or used to show the position or order of something
country - an area of land that has its own government, army, etc.
juice - the liquid that comes from fruit or vegetables
that - used to refer to something or someone that can be seen or pointed to
year - a period of twelve months, especially from January 1st to December 31st
fruit - something such as an apple or orange that grows on a tree or a bush, contains seeds, and can be eaten as food
possible - If something is possible, it can happen or be done.
tomorrow - on the day after today
of - belonging or relating to someone or something
little - small in size or amount
sleep - to be in the state of rest when your eyes are closed, your body is not active, and your mind is unconscious
night - the time in every 24 hours when it is dark and people usually sleep
come - to move or travel toward a person who is speaking or the place that they are speaking about
shoe - a strong covering for the foot, often made of leather
bike - a bicycle
sixteen - the number 16
ticket - a small piece of paper that shows you have paid to do something, for example travel on a bus, watch a movie, etc.
fifteen - the number 15
hard - difficult to understand or do
tomato - a soft, round, red fruit eaten in salad or as a vegetable
beer - an alcoholic drink made from grain
have - to own or possess
between - in the space that separates two places, people or objects
wash - to clean something using water
course - a set of classes or a plan of study in a particular subject, usually a part of a program of study for a diploma, certificate, or degree
more - something in addition to what you already have
better - (<span class="i">comparative of
window - a space usually filled with glass in the wall of a building or in a vehicle, to allow light and air in and to allow people inside the building to see out
cracker - a  flat, dry, small baked bread
bookstore - a store where books are sold
cell phone - a telephone that you can carry everywhere with you
all - every person or thing in a group
o'clock - used after the numbers one to twelve to mean exactly that hour when you tell the time
pet - an animal that someone keeps in their home
today - on this day
bat - a specially shaped piece of wood used for hitting the ball in many games
job - the regular work that you do in order to earn money
fly - to travel through the air  in an aircraft
difficult - when something is not easy to do or understand
go - to move or travel somewhere
road - a route between places, usually with a hard surface built for vehicles to drive on
glasses - a piece of equipment with two transparent parts that you wear in front of your eyes to help you see better
at - used to show the place or position of something
busy - If you are busy, you are working hard, or giving your attention to a particular thing
drink - a liquid or an amount of liquid which is taken into the body through the mouth
her - used after a verb or preposition to refer to someone female who has already been talked about
living room - the room in a house where people sit to relax and, for example, watch television
phone - a piece of electronic equipment that you use  to talk to someone who is in another place
poor - having very little money or few possessions
grass - a common plant with narrow green leaves that grows close to the ground
face - the front part of the head, where the eyes, nose and mouth are, or the expression on this part
happy - feeling, showing, or causing pleasure
soup - a usually hot, liquid food made from vegetables and sometimes meat or fish cooked in water
each - every one  in a group of two or more things or people when they are considered separately
hospital - a place where ill or injured people go to be treated by doctors and nurses
T-shirt - a piece of cotton clothing for the top part of the body with short sleeves and no collar
can - to be able to
five - the number 5
never - not ever, not one time
yes - used to agree with something, or to give a positive answer
tall - having a greater than average height
bread - a basic food made by mixing flour, water and sometimes  yeast
can - to be able to
look - to turn your eyes in the direction of something or someone so that you can see them
good - enjoyable, pleasant or interesting
bye - goodbye
catch - to take hold of something, especially something that is moving through the air
lesson - a period of time when a teacher teaches people
month - one of the twelve periods of time that a year is divided into
long - continuing for a large amount of time
book - a set of attached pages in a cover, with words or pictures that tell a story or provide information
then - at that time
good - enjoyable, pleasant or interesting
student - a person who is learning at a school or in college
cat - a small animal with fur, four legs and a tail that is kept as a pet
travel - to make a trip
new - recently made or having started to exist recently
ready - prepared for doing something
me - used after a verb or preposition to refer to the person who is speaking or writing
or - used between possibilities, or before the last in a list of possibilities
and - used to join two words, phrases, parts of sentences or related statements together
glass - a hard transparent substance that objects such as windows and bottles are made of
taxi - a car with a driver who you pay to take you somewhere
knife - a sharp tool, usually with a metal blade and a handle, used for cutting and spreading food or other substances, or as a weapon
goodbye - something you say when you leave someone or when they leave you
vegetable - a plant that you eat, for example potatoes, onions, beans, etc.
that - used to refer to something or someone that can be seen or pointed to
now - at the present time
weekend - Saturday and Sunday, or Friday evening until Sunday night; the part of the week when many people do not work
salt - a white substance used to add flavor to food
it - used to refer to the thing, situation, or idea that has already been talked about
boy - a male child or young man
zoo - a place where  wild animals are kept so that people can go and look at them
understand - to know the meaning of something that someone says
sister - a girl or woman who has the same parents as another person
there - used to show that something exists or happens
bath - when you wash your body in a bathtub
thank you - used to tell someone that you are grateful because they have given you something, done something for you or made a polite remark
like - to enjoy something or feel that someone or something is pleasant
too - used before adjectives and adverbs to mean "more than is allowed, necessary, possible, etc."
town - a place with houses, stores, and other buildings where people live and work that is smaller than a city
nice - pleasant or attractive
